....##.###.###.#..
......#...#.......
......#...#...R...
..^...............
......#...#.......
......#...#...G...
......#...#.......
..................
..D...#...#...B...
......#...#.......
..................
....##.###.###.#..
